3 8
WWWWWWWWWWWWWWWWWWWW
W....W...WW....WG..W
W.WWWWWW.W..WWWWWW.W
W.W...W..W.WW.W....W
W.W.W.W.WW.WW.WWW.WW
W.W.W.......W.W....W
W.W.WWW..WW.W.W.W..W
W.W.W.WWWWW.W.W.WWWW
W.........W...W....W
W.W.W.WW.WWW.WWWW.WW
W.WWWWWW.WWW.W.WW.WW
W....W...WW....W...W
W.WWWWWW....W.WWWW.W
W.W...W..WW.W.W....W
W.W.W.W.WWW.W.W.WWWW
W.W.W.....W.W.W...WW
W.W.WWW..WW.W...W..W
W.W.W.WWWW..WWW.WW.W
W........W.........W
WWWWWWWWWWWWWWWWWWWW
